111111111111111111111111111111111111111111111111111111
1P0000000C00000000000S00000000C0000000S000000000000E11
100011111111000011111000111110001111100011111000111111
100000000S000000000000000C00000000000S0000000000000001
111111000111111000111111000111111000111111000111111001
100000000000C00000S00000000000000000C0000S000000000001
100111111111000111111000111110001111100011111000111111
1000000C0000000000S0000000C000S0000000000000C000000011
111111000111111000111111000111111000111111000111111001
1S0000000000000000000C00S00000000S000000000000C0000011
100111111111000111111000111110001111100011111000111111
100000S000C00000000000000000S0000C0000000S0000C0000011
111111111111111111111111111111111111111111111111111111