111111111111111111111111111111111111111111111111111111
1P00000C0000111111000000S00000000000111111000C00000011
100011100000000001001111111111100000000001000111110001
1S0011100C00S000000000000C000000000S000000000111110S11
111111111111100001111100000011111000010011111111111111
1000000S0000000000000000S00000000000000000000S00000011
100011111111111100111111111111111100111111111111110001
1C00000000C0000000000000000000000000000000C00000000111
100011111111111100111111111111111100111111111111110001
1000000S0000000000000000S00000000000000000000S00000011
111111111111100001111100000011111000010011111111111111
1S0011100C00S000000000000C000000000S000000000111110S11
100011100000000001001111111111100000000001000111110001
1000000C0000111111000000S00000000000111111000C00000E11
111111111111111111111111111111111111111111111111111111