111111111111111111111111111111111111111111111111111111
1P0000C00000000S000000000C00000S000000000C000000000011
101010101111110111111011111101111111011111111010101101
1000S0000C00000000000000000000000000000000C0000S000011
101010101111111111110111111111111011111111110101011101
1S0000000000C0000S0000000C0000S0000000C00000000000S111
101010101110111111111000111100111111011111110101011101
1C0000S00000000000000000000000000000000000000S0000C011
101010101111110111111000111100111111011111110101011101
100000000C00000000S00000000000S000000000C0000000000011
101010101111111111110111111111111011111111110101011101
1S0000000000C0000000000000000000000000C00000000000S111
101010101110111111111000111100111111011111110101011101
1C0000S00000000000000000000000000000000000000S0000C011
101010101111110111111000111100111111011111110101011101
100000000000000000S00000000000S00000000000000000000E11
111111111111111111111111111111111111111111111111111111