1111111111111111111111111111
1P00000000000C00S00000000E11
1011111110000000001111111011
1S00C00000S0000C000000000111
1011111110000000001111111011
100000S000C0000S0000C0000111
1011111000111111100011111011
1C0000000S00000000S000000C11
1011111000000000000111111011
1S0000C00000S0C0000000000111
1011111000111111100011111011
100000S000C0000S0000C0000111
1011111110000000001111111011
1C00000000S0000C00000000C111
1011111110000000001111111011
1S0000000000S0C0000000000111
1000000111000000011100000001
100C0S000000C0S0000000C00111
1000000111000000011100000001
100000000S000C00000S00000111
1111111111111111111111111111