1111111111111111111111111111111
1P00C00000000000011100000000001
1011111111011111101011111110101
1000000C0010S0000000S00C0000011
1011111111101111111110111111101
1000S00000000000000000000S00001
1010111110111111110111111111101
10C0000000000C00000000000000C01
1010111110111111110111111111101
1000000000000000S00000000000001
1011111111101111111110111111101
1000000C0010S0000000S00C0000011
1011111111011111101011111110101
1000C00000000000011100000000E11
1111111111111111111111111111111