11111111111111111
1P000000S00000E11
100111111111S0011
1S000000000000S11
10011111111110S11
100000S00000S0011
11111111111111111