11111111111111111
1P111111111111111
10C00000010000011
11111111111111011
1E000000000000011
11111111111111111