11111111111111111
1000SC00S00000E11
100111111111S0011
1S00000C000000011
10011111111110S11
1C0000S000C000011
11111111111111111