11111111111111111
1P000C00S00000C11
100111111111S0011
1S00000C000000011
10011111111110S11
1C0000S000C000011
11111111111111111